NO ./sprites/NO.xpm
SO ./sprites/SO.xpm
WE ./sprites/WE.xpm
EA ./sprites/EA.xpm

F 255,100,0
C 225,30,0

111111111111111111111111
1000000000110000000000001
1011000001110000000000001
1001000000000000W0000001111111111
111111111011000001110000000000001 1
100000000011000001110111111111111
11110111111111011100000010001
11110111111111011101010010001
11000010010101011100000010001
1000010100000000110000001000 
10000010000000001101010010001
11000001110101011111011110000111
11110111 1110101 101111010001
11111111 1111111 111111011111




