NO ./sprites/NO.xpm
SO ./sprites/SO.xpm
WE ./sprites/WE.xpm
EA ./sprites/EA.xpm

F 255,100,0
C 225,30,0

1111111111111111111111111111111
10S0000111100000011110000000001
10111010100101111000101111011101
10100010100101000000101000010001
10101110111101111110101111110101
10100010000000000010100000000101
10111110111111111010111111110101
10000000100000000010000000000101
10111110101111111111111111011101
10000000101000000000000001000001
10111110101111111110111111011101
10100000100000000010100000000001
10101111101111111110101111111101
10100000000000000000100000000001
10111010100101111000101111011101
10100010100101000000101000010001
10101110111101111110101111110101
10100010000000000010100000000101
10111110111111111010111111110101
10000000100000000010000000000101
10111110101111111111111111011101
10000000101000000000000001000001
10111110101111111110111111011101
10100000100000000010100000000001
10101111101111111110101111111101
10100000000000000000100000000001
11111111111111111111111111111111