NO asset/50.xpm
SO asset/25.xpm
WE asset/75.xpm
EA asset/0.xpm

C 135, 206, 235
F 237, 201, 175

111111111111111111111111
1000000000110000000000001
1011000001110000000000001
10010000000000000000000111111111
111111111011000001110000000000001
100000000011000001110111111111111
11110111111111011100000010001
11110111111111011101010010001
11000000010101011100000010001
100000N0000000001100000010001
10000000000000001101010010001
11000001110101011111011110000111
11110111 1110101 101111010001
11111111 1111111 111111111111